Det er mandag morgen. Alex ligger på en madrass og tenker. Han er ikke i Paris, han er i Fjordvik i Norge. Her skal de bo. Han skal gå i barnehagen her. Dina skal gå på skolen. Mamma og pappa skal jobbe.

Mamma kommer inn til Alex. Hun smiler.

Mamma: God morgen, Alex! Er du våken?
Alex: Hei, mamma. Hva skal vi gjøre i dag?
M: Vi skal være hjemme. Vi skal være sammen, du og Dina og pappa og jeg.
A: Men hva skal vi gjøre?
M: Vi venter på en flyttebil. Men nå skal vi spise frokost. Kommer du?
A: Ja, jeg kommer.
Frokost. Foto: Synøve DreyerM: Dina! Ben! Nå er det frokost.

De sitter rundt bordet og spiser frokost sammen. Det er hyggelig. Dina sier noe morsomt. Pappa ler, og mamma smiler.

Alex sitter og tenker. Han er i Norge nå. Han kjenner bare mamma, pappa og Dina her. Han må finne en venn.

ligger - lying 
madrass - mattress 
tenker - thinking 
Her skald de bo - There they are going to live 
skolen - school 
skal på jobbe - got to work 
kommer inn til - comes in to 
kommer til - comes to
Er du våken - Are you awake?
Hva skal vi gjøre i dag? - What will we do today? 
Vi skal være hjemme - We will stay home 
Vi skal være sammen - We will stay together 
Vi venter på en fluttebil - We´re waiting for a moving lorry. 
skal - shall 
Nå er det frokost. 
Dina sier noe morsomt - Dina says something funny 
Pappa ler - dad laughs 
smiler - smile 
sitter og tenker - sits and thinks 
Han kjenner bare - He knows only 
Han må finne en venn - He must find a friend 